MAX_LEVELS = 2;
PLAYER_START_X = 123;
PLAYER_START_Y = 414;
ACTUAL_LEVELS = 2;
Level 1:
624 415 148 13 0 1 0 1 0
54 289 148 37 0 1 0 1 0
271 451 82 58 0 1 0 1 0
0 498 800 102 0 1 0 1 0
434 209 131 39 0 1 0 1 0
407 471 41 26 1 0 0 1 1
Level 2:
0 567 800 33 0 1 0 1 0
464 492 140 90 0 1 0 1 0
